MAZE: "mylevel", ' '
FLAGS:premapped
INIT_MAP: solidfill,' '
GEOMETRY:center,center
MAP
-------------
|.....WW....|
|.....WW....|
|.....WW....|
|.....WW....|
|.....WW....|
-------------
ENDMAP
REGION:(0,0,12,6),lit,"ordinary"
$left_bank = selection:fillrect (1,1,5,5)
$right_bank = selection:fillrect (8,1,11,5)
OBJECT:('=',"levitation"),rndcoord($left_bank),blessed
BRANCH:(1,1,5,5),(0,0,0,0)
STAIR:rndcoord($right_bank),down